12 x 12
0 0 0 96 96 0 0 0 0 0 0 0
0 16 16 16 16 16 16 0 0 0 0 0
0 0 0 0 0 0 0 0 0 0 0 0
52 0 0 0 0 0 0 0 0 0 0 0
64 0 0 0 0 33 0 82 0 0 0 0
0 0 0 0 0 0 0 0 0 0 0 0
37 0 0 0 96 0 0 0 0 0 0 0
0 0 0 0 0 0 0 0 0 0 0 0
0 0 0 0 0 0 0 0 0 0 0 0
0 0 0 0 0 0 0 96 0 0 0 0
0 0 0 0 0 0 0 0 0 0 0 0
0 0 0 49 0 0 0 0 0 0 0 0