12 x 12
96 0 0 81 82 83 64 84 0 0 0 0
16 16 16 0 0 0 16 16 16 16 0 0
0 0 0 0 16 33 16 0 0 16 0 0
38 0 0 0 16 34 16 0 0 16 0 0
0 0 0 0 16 35 16 0 0 16 0 0
0 0 0 0 16 16 16 0 0 16 0 0
0 0 0 0 0 0 0 0 0 16 0 0
0 0 85 0 0 96 0 0 0 16 0 0
0 0 0 0 0 0 0 0 0 16 0 0
37 0 0 0 0 0 0 0 0 16 0 0
32 16 16 16 16 16 16 16 16 16 0 36 
32 0 50 0 0 0 0 0 0 0 0 96 


