12 x 12
0 0 0 0 0 0 0 0 0 0 0 0
0 0 0 0 0 0 0 0 0 0 0 0
0 0 0 0 0 0 0 0 0 0 0 0
51 0 0 0 0 0 0 0 0 0 0 0
0 0 0 0 0 96 0 96 0 0 0 0
0 0 0 17 16 34 35 34 16 17 0 0
0 0 0 17 16 96 18 96 16 17 0 0
0 0 0 17 16 16 16 16 16 17 0 0
0 0 0 17 17 17 17 17 17 17 0 0
0 0 0 0 0 0 0 0 0 0 0 0
0 0 0 0 96 0 0 0 96 0 0 0
0 0 0 0 0 0 0 0 0 0 0 0


